#alias '-'='cd -'
alias ..='cd ..'
alias ...='cd ../..'
alias df='df -h'
alias dsstore='find . -name '\''*.DS_Store'\'' -type f -ls -delete'
alias eachdir='. eachdir'
alias flush='dscacheutil -flushcache'
alias fs='stat -f '\''%z bytes'\'''
alias g='git'
alias gb='git branch'
alias gba='git branch -a'
alias gbc='gc -b'
alias gcb='gc -b'
alias gcd='git rev-parse 2>/dev/null && cd "./$(git rev-parse --show-cdup)"'
alias gcl='git clone'
alias gco='gc'
alias gd='git diff'
alias gdc='gd --cached'
alias gf1='gf -n 1'
alias gf2='gf -n 2'
alias gf3='gf -n 3'
alias gf4='gf -n 4'
alias gf5='gf -n 5'
alias gg='gl --decorate --oneline --graph --date-order --all'
alias gl="git log --graph --pretty=format:'%Cred%h%Creset -%C(yellow)%d%Creset %s %Cgreen(%cr) %C(bold blue)<%an>%Creset' --abbrev-commit"
alias gm='git commit -m'
alias gma='git commit -am'
alias gp='git push'
alias gp-all='eachdir git push'
alias gpa='gp --all'
alias gr='git remote'
alias grr='git remote rm'
alias grv='gr -v'
alias gs='git status'
alias gs-all='eachdir git status'
alias gst='gs'
alias gu='git pull'
alias gu-all='eachdir git pull'
alias httpdump='sudo tcpdump -i en1 -n -s 0 -w - | grep -a -o -E "Host\: .*|GET \/.*"'
alias install='sudo apt-get install'
alias ls='command ls --color'
alias ll='ls -la --color'
alias lsd='ll -d'
alias nave_stable='nave use default stable nave_stable_2 $(node --version 2>/dev/null); src'
alias npm_link='rm -rf node_modules; npm install; linken . --src ..'
alias npm_link_grunt='linken . --src ~/gruntjs'
alias npm_linkall='eachdir "rm -rf node_modules; npm install"; linken */ --src .'
alias npm_owner_list='eachdir "npm owner ls 2>/dev/null | sort"'
alias prompt_getcolors='prompt_colors[9]=; local i; for i in ${!prompt_colors[@]}; do local c$i="\[\e[0;${prompt_colors[$i]}m\]"; done'
alias q='nano -w -z'
alias q.='q .'
alias r='fc -s'
alias remove='sudo apt-get remove'
alias search='apt-cache search'
alias t='tree --dirsfirst -L 2'
alias update='sudo apt-get -qq update && sudo apt-get upgrade'
alias wanip='dig +short myip.opendns.com @resolver1.opendns.com'
alias whois='whois -h whois-servers.net'
alias z='_z 2>&1'
alias rmdocker='sudo docker.io ps -a --quiet | while read id; do sudo docker.io rm $id; done'
alias docker='sudo docker.io'
alias dps='sudo docker.io ps -a'

function dockerclean(){
    sudo docker.io images | awk '$1 == "<none>" {print $3}' | while read id; do sudo docker.io rmi $id; done
}

function gitsetauthor(){
    git filter-branch -f --env-filter "GIT_AUTHOR_NAME='Santosh Sahoo'; GIT_AUTHOR_EMAIL='me@santoshsahoo.com'; GIT_COMMITTER_NAME='Santosh Sahoo'; GIT_COMMITTER_EMAIL='me@santoshsahoo.com';" HEAD
}

alias sa='scss --trace --watch sass:www/static/css'
